50
20
24 26 00 00 00 00 00 00 00 00 00 00 00 00 00 00 00 00 00 00 00 00 00 00 00 00 00 00 00 00 00 00 00 00 00 00 00 00 00 00 00 00 00 00 00 00 00 00 00 00
24 26 00 00 00 00 00 00 00 00 00 00 00 00 00 00 00 00 00 00 00 00 00 00 00 00 00 00 00 00 00 00 00 00 00 00 00 00 00 00 00 00 00 00 00 00 00 00 25 24
24 24 00 00 00 00 00 00 00 00 00 00 00 00 00 00 00 00 00 00 00 00 00 00 00 00 00 00 00 00 00 00 00 00 00 00 00 00 00 00 00 00 00 00 00 00 00 00 24 24
22 24 00 00 00 00 00 00 00 00 00 00 00 00 00 00 00 00 00 00 00 00 00 00 00 00 00 00 00 00 00 00 00 00 00 00 00 00 00 00 00 00 00 00 00 00 00 00 24 24
22 24 00 00 00 00 00 00 00 00 00 20 20 00 00 00 00 05 00 00 00 00 00 00 20 00 00 00 00 00 00 05 00 00 00 00 20 20 00 00 00 00 00 00 00 00 00 00 24 24
22 24 00 00 00 00 05 00 00 00 20 00 00 00 19 20 20 21 00 00 00 00 00 00 00 00 00 00 00 00 00 19 20 20 21 00 00 00 20 00 00 05 00 00 00 00 00 00 24 24
22 24 14 00 00 19 19 20 20 21 00 00 00 00 00 00 00 00 00 16 03 00 00 00 04 00 00 00 03 18 00 00 00 00 00 00 00 00 00 19 20 20 21 00 00 00 00 14 24 24 
22 24 15 14 00 00 00 00 00 00 16 00 00 00 00 00 00 00 00 19 19 20 20 20 20 20 20 20 20 21 00 00 00 00 00 00 00 00 18 00 00 00 00 00 00 00 14 15 24 24
22 24 15 15 14 00 00 00 00 00 19 20 20 20 20 20 20 21 00 00 00 00 00 00 00 00 00 00 00 00 00 19 20 20 19 20 20 20 21 00 00 00 00 00 00 14 15 15 24 24
22 24 15 15 15 14 00 00 00 00 00 00 00 00 00 00 00 00 00 00 00 00 00 00 00 00 00 00 00 00 00 00 00 00 00 00 00 00 00 00 00 00 00 00 14 15 15 15 24 24
22 24 15 15 15 15 14 00 06 06 06 06 06 06 00 00 00 00 00 08 00 00 00 07 07 07 00 00 00 08 00 00 00 00 00 00 06 06 06 06 06 06 00 14 15 15 15 15 24 24
22 15 15 15 15 15 15 14 14 14 14 14 14 14 14 14 14 14 14 14 14 14 14 14 14 14 14 14 14 14 14 14 14 14 14 14 14 14 14 14 14 14 14 14 14 14 14 14 14 24 
22 15 15 15 15 15 15 15 15 15 15 15 15 15 15 15 15 15 15 15 15 15 15 15 15 15 15 15 15 15 15 15 15 15 15 15 15 15 15 15 15 15 15 15 15 15 15 15 15 24
22 15 15 15 15 15 15 15 15 15 15 15 15 15 15 15 15 15 15 15 15 15 15 15 15 15 15 15 15 15 15 15 15 15 15 15 15 15 15 15 15 15 15 15 15 15 15 15 15 24
22 15 15 15 15 15 15 15 15 15 15 15 15 15 15 15 15 15 15 15 15 15 15 15 15 15 15 15 15 15 15 15 15 15 15 15 15 15 15 15 15 15 15 15 15 15 15 15 15 24
22 15 15 15 15 15 15 15 15 15 15 15 15 15 15 15 15 15 15 15 15 15 15 15 15 15 15 15 15 15 15 15 15 15 15 15 15 15 15 15 15 15 15 15 15 15 15 15 15 24
22 15 15 15 15 15 15 15 15 15 15 15 15 15 15 15 15 15 15 15 15 15 15 15 15 15 15 15 15 15 15 15 15 15 15 15 15 15 15 15 15 15 15 15 15 15 15 15 15 24
22 00 00 00 00 00 00 00 00 00 00 00 00 00 00 00 00 00 00 00 00 00 00 00 00 00 00 00 00 00 00 00 00 00 00 00 00 00 00 00 00 00 00 00 00 00 00 00 00 00
22 00 00 00 00 00 00 00 00 00 00 00 00 00 00 00 00 00 00 00 00 00 00 00 00 00 00 00 00 00 00 00 00 00 00 00 00 00 00 00 00 00 00 00 00 00 00 00 00 00
00 00 00 00 00 00 00 00 00 00 00 00 00 00 00 00 00 00 00 00 00 00 00 00 00 00 00 00 00 00 00 00 00 00 00 00 00 00 00 00 00 00 00 00 00 00 00 00 00 00
